[valutes]
0=Другая валюта
AUD=Австралийский доллар
AZN=Азербайджанский манат
GBP=Фунт стерлингов Соединенного королевства
AMD=Армянский драм
BYR=Белорусский рубль
BGN=Болгарский лев
BRL=Бразильский реал
HUF=Венгерский форинт
DKK=Датская крона
USD=Доллар США
EUR=Евро
INR=Индийская рупия
KZT=Казахский тенге
CAD=Канадский доллар
KGS=Киргизский сом
CNY=Китайский юань
LVL=Латвийский лат
LTL=Литовский лит
MDL=Молдавский лей
NOK=Норвежская крона
PLN=Польский злотый
RON=Новый румынский лей
XDR=СДР (специальные права заимствования)
SGD=Сингапурский доллар
TJS=Таджикский сомони
TRY=Турецкая лира
TMT=Новый туркменский манат
UZS=Узбекский сум
UAH=Украинская гривна
CZK=Чешская крона
SEK=Шведская крона
CHF=Швейцарский франк
EEK=Эстонская крона
ZAR=Южноафриканский рэнд
KRW=Вон Республики Корея
JPY=Японская иена